Instr NO.0	func_tensor_store	is activated
Instr NO.1	func_tensor_store	is activated
Instr NO.2	func_tensor_store	is activated
Instr NO.3	func_tensor_store	is activated
Instr NO.4	func_tensor_store	is activated
Instr NO.5	func_tensor_store	is activated
Instr NO.6	func_tensor_store	is activated
Instr NO.7	func_tensor_store	is activated
Instr NO.8	func_tensor_store	is activated
Instr NO.9	func_tensor_store	is activated
Instr NO.10	func_tensor_store	is activated
Instr NO.11	func_tensor_store	is activated
Instr NO.12	func_tensor_store	is activated
Instr NO.13	func_tensor_store	is activated
Instr NO.14	func_tensor_store	is activated
Instr NO.15	func_tensor_store	is activated
Instr NO.16	func_tensor_store	is activated
Instr NO.17	func_tensor_store	is activated
Instr NO.18	func_tensor_store	is activated
Instr NO.19	func_tensor_store	is activated
Instr NO.20	func_tensor_store	is activated
Instr NO.21	func_tensor_store	is activated
Instr NO.22	func_tensor_store	is activated
Instr NO.23	func_tensor_store	is activated
Instr NO.24	func_tensor_store	is activated
Instr NO.25	func_tensor_store	is activated
Instr NO.26	func_tensor_store	is activated
Instr NO.27	func_tensor_store	is activated
Instr NO.28	func_tensor_store	is activated
Instr NO.29	func_tensor_store	is activated
Instr NO.30	func_tensor_store	is activated
Instr NO.31	func_tensor_store	is activated
Instr NO.32	func_maxpooling_2d	is activated
Instr NO.33	child_call_find_max	is activated
Instr NO.34	maxpooling_find_max_op	is activated
Instr NO.35	maxpooling_find_max_op	is activated
Instr NO.36	child_write_max_value	is activated
Instr NO.37	child_update_var	is activated
Instr NO.38	child_loop_X_update	is activated
Instr NO.39	child_call_find_max	is activated
Instr NO.40	maxpooling_find_max_op	is activated
Instr NO.41	maxpooling_find_max_op	is activated
Instr NO.42	child_write_max_value	is activated
Instr NO.43	child_update_var	is activated
Instr NO.44	child_loop_X_update	is activated
Instr NO.45	child_call_find_max	is activated
Instr NO.46	maxpooling_find_max_op	is activated
Instr NO.47	maxpooling_find_max_op	is activated
Instr NO.48	child_write_max_value	is activated
Instr NO.49	child_update_var	is activated
Instr NO.50	child_loop_X_update	is activated
Instr NO.51	child_call_find_max	is activated
Instr NO.52	maxpooling_find_max_op	is activated
Instr NO.53	maxpooling_find_max_op	is activated
Instr NO.54	child_write_max_value	is activated
Instr NO.55	child_update_var	is activated
Instr NO.56	child_loop_X_update	is activated
Instr NO.57	child_call_find_max	is activated
Instr NO.58	maxpooling_find_max_op	is activated
Instr NO.59	maxpooling_find_max_op	is activated
Instr NO.60	child_write_max_value	is activated
Instr NO.61	child_update_var	is activated
Instr NO.62	child_loop_X_update	is activated
Instr NO.63	child_call_find_max	is activated
Instr NO.64	maxpooling_find_max_op	is activated
Instr NO.65	maxpooling_find_max_op	is activated
Instr NO.66	child_write_max_value	is activated
Instr NO.67	child_update_var	is activated
Instr NO.68	child_loop_X_update	is activated
Instr NO.69	child_call_find_max	is activated
Instr NO.70	maxpooling_find_max_op	is activated
Instr NO.71	maxpooling_find_max_op	is activated
Instr NO.72	child_write_max_value	is activated
Instr NO.73	child_update_var	is activated
Instr NO.74	child_loop_X_update	is activated
Instr NO.75	child_call_find_max	is activated
Instr NO.76	maxpooling_find_max_op	is activated
Instr NO.77	maxpooling_find_max_op	is activated
Instr NO.78	child_write_max_value	is activated
Instr NO.79	child_update_var	is activated
Instr NO.80	child_loop_X_update	is activated
Instr NO.81	child_call_find_max	is activated
Instr NO.82	maxpooling_find_max_op	is activated
Instr NO.83	maxpooling_find_max_op	is activated
Instr NO.84	child_write_max_value	is activated
Instr NO.85	child_update_var	is activated
Instr NO.86	child_loop_X_update	is activated
Instr NO.87	child_call_find_max	is activated
Instr NO.88	maxpooling_find_max_op	is activated
Instr NO.89	maxpooling_find_max_op	is activated
Instr NO.90	child_write_max_value	is activated
Instr NO.91	child_update_var	is activated
Instr NO.92	child_loop_X_update	is activated
Instr NO.93	child_call_find_max	is activated
Instr NO.94	maxpooling_find_max_op	is activated
Instr NO.95	maxpooling_find_max_op	is activated
Instr NO.96	child_write_max_value	is activated
Instr NO.97	child_update_var	is activated
Instr NO.98	child_loop_X_update	is activated
Instr NO.99	child_call_find_max	is activated
Instr NO.100	maxpooling_find_max_op	is activated
Instr NO.101	maxpooling_find_max_op	is activated
Instr NO.102	child_write_max_value	is activated
Instr NO.103	child_update_var	is activated
Instr NO.104	child_loop_X_update	is activated
Instr NO.105	child_call_find_max	is activated
Instr NO.106	maxpooling_find_max_op	is activated
Instr NO.107	maxpooling_find_max_op	is activated
Instr NO.108	child_write_max_value	is activated
Instr NO.109	child_update_var	is activated
Instr NO.110	child_loop_X_update	is activated
Instr NO.111	child_call_find_max	is activated
Instr NO.112	maxpooling_find_max_op	is activated
Instr NO.113	maxpooling_find_max_op	is activated
Instr NO.114	child_write_max_value	is activated
Instr NO.115	child_update_var	is activated
Instr NO.116	child_loop_X_update	is activated
Instr NO.117	child_call_find_max	is activated
Instr NO.118	maxpooling_find_max_op	is activated
Instr NO.119	maxpooling_find_max_op	is activated
Instr NO.120	child_write_max_value	is activated
Instr NO.121	child_update_var	is activated
Instr NO.122	child_loop_X_update	is activated
Instr NO.123	child_call_find_max	is activated
Instr NO.124	maxpooling_find_max_op	is activated
Instr NO.125	maxpooling_find_max_op	is activated
Instr NO.126	child_write_max_value	is activated
Instr NO.127	child_update_var	is activated
