Instr NO.0	CONFIG_GB_LAYER_REDUCE	is activated
Instr NO.1	CONFIG_GB_CORE_MEM_MNGR_LARGE	is activated
Instr NO.2	GB_CORE_STORE_LARGE	is activated
Instr NO.3	GB_CORE_STORE_LARGE	is activated
Instr NO.4	GB_LAYER_REDUCE_START	is activated
Instr NO.5	gb_layer_reduce_group_level_op	is activated
Instr NO.6	gb_layer_timestep_level_op	is activated
Instr NO.7	gb_layer_vector_level_op	is activated
Instr NO.8	gb_layer_byte_level_op	is activated
Instr NO.9	gb_layer_byte_level_op	is activated
Instr NO.10	gb_layer_byte_level_op	is activated
Instr NO.11	gb_layer_byte_level_op	is activated
Instr NO.12	gb_layer_byte_level_op	is activated
Instr NO.13	gb_layer_byte_level_op	is activated
Instr NO.14	gb_layer_byte_level_op	is activated
Instr NO.15	gb_layer_byte_level_op	is activated
Instr NO.16	gb_layer_byte_level_op	is activated
Instr NO.17	gb_layer_byte_level_op	is activated
Instr NO.18	gb_layer_byte_level_op	is activated
Instr NO.19	gb_layer_byte_level_op	is activated
Instr NO.20	gb_layer_byte_level_op	is activated
Instr NO.21	gb_layer_byte_level_op	is activated
Instr NO.22	gb_layer_byte_level_op	is activated
Instr NO.23	gb_layer_byte_level_op	is activated
Instr NO.24	gb_layer_reduce_done	is activated
